SO                           teste1 SO
NO                           teste2 NO
WE test
EA  teste EA 

C 242,42,242
F 23,42,24


111111111111111111111111111111111111111111111
10001
100011111111
100011100001
10001 100001
10001 100001
100011100001
100000000001
100000000001
111111111111




                                                    
													  
														    













































