
NO assets/img2.xpm
SO assets/img.xpm
WE assets/brick.xpm
EA assets/img3.xpm

F 0,0,0
C 255,255,255

	1111111111111111
	1111000000000011
	1111111001111111
	1100000000011111
1111100N0000011
100000000111111111
111111110000001111
11111110000000011111
	111100000000000111
	1111100000000111
11111000001111
111111000111111
111111111111111
