
EA assets/img3.png
NO assets/brick.png
SO assets/img.png
WE assets/img2.png

C 99,99,99
F 76,76,76

                            1111111111111111111111111111111111111111111111111111111
							11111010010W1100001
							1011000001000011111
							1111101001111101111
							1111111111111001001
							1000001111111111111
							1111111111111001001
							1111000000000001011
							1000000001000000001
							1111111111111111111
