F 76,26,76
C 254,255,113

NO assets/img2.xpm
SO assets/img.xpm
WE assets/brick.xpm
EA assets/img3.xpm

    1111 1 1111111111
111111011111111
111110000011111
1111100W0001111
    1100000000011111
111110000000011
    100000000111111111
111111110000001111
111000000000111
111100000001111
    111110000011111
111111000111111
111111111111111
