
NO assets/img2.xpm
SO assets/img.xpm
WE assets/brick.xpm
EA assets/img3.xpm

F 20,230,58
C 20,230,58


111111111111111
1000000000000011
11111110000000011
      100000S00011
1111111000000000011
      10000000000011
111111100000000000011
111111100000000000001
     111111111111111111

     sdfjlksfd
     sdfjsfdksfd
     sdf
     sfd
     jsfdj
     sfd
     jsf
